C395555553
9685155796
AFAFAFFFC3
AFEF857F92
AFFFAFFFAA
C3BFAFD52E
BC2FAFFF83
83C3A93D2A
AE96EAC1EA
C54556D456

0,0
7,8
ESWSSSSESESESWSEEENNESE
